9
8
w w w w w w w w w
w o o o o o o o w
w o w w w w w o w
w o w o o o w o w
w o w o w h w o w
w o w o w w w o w
w p w o o o o o w
w w w w w w w w w