6
6
w w w w w w
w p o o o w
w o b o o w
w o o o o w
w o o o h w
w w w w w w